3,10,10,14,7,11,10,10,10,6
5,11,2,10,8,14,7,7,7,5
5,3,0,2,10,14,1,8,12,5
5,5,13,9,10,2,8,6,7,13
13,1,2,2,14,13,7,1,8,14
11,4,13,9,2,2,8,8,14,7
7,5,7,11,4,13,3,10,14,5
5,1,0,6,1,10,8,10,14,5
5,13,13,13,9,2,10,10,14,5
9,10,10,10,14,13,11,10,10,12
