11,6,7,11,2,6,11,6,3,14
10,0,12,7,5,13,11,4,1,14
10,4,11,8,8,6,11,4,1,14
3,8,10,10,10,4,7,1,0,6
1,10,2,10,2,0,8,4,13,13
5,15,0,14,13,5,7,13,3,14
5,7,5,7,7,1,0,10,4,7
13,1,8,0,12,5,5,11,0,4
3,0,14,13,11,4,13,3,4,5
13,11,14,11,10,8,14,13,13,13
